2bmr-jdsv.DBA.txt.gz_	business_name
2bnn-yakx.Vehicle_Body_Type.txt.gz	vehicle_type
2bnn-yakx.Vehicle_Color.txt.gz	color
2bnn-yakx.Vehicle_Make.txt.gz	car_make
2sps-j9st.PERSON_FIRST_NAME.txt.gz	person_name
2sps-j9st.PERSON_LAST_NAME.txt.gz	person_name
2v9c-2k7f.DBA.txt.gz	business_name
2xh6-psuq.Project_School_Name.txt.gz,school_name	school_name
3aka-ggej.BOROUGH.txt.gz	other
3aka-ggej.CORE_SUBJECT___MS_CORE_and__09_12_ONLY_.txt.gz	subjects_in_school
3btx-p4av.COMPARABLE_RENTAL___2__Building_Classification.txt.gz	buiding_classification
3h2n-5cm9.STREET.txt.gz	street_name
3rfa-3xsf.Cross_Street_2.txt.gz	street_name
3rfa-3xsf.Incident_Zip.txt.gz	zip_code
3rfa-3xsf.Location.txt.gz	lat/lon_coordinates
3rfa-3xsf.School_Name.txt.gz	park/playground
3rfa-3xsf.School_Phone_Number.txt.gz	phone_number
3rfa-3xsf.Street_Name.txt.gz	street_name
43nn-pn8j.DBA.txt.gz	business_name
4fnu-iufz.Agency.txt.gz	city_agency
4n2j-ut8i.SCHOOL_LEVEL_.txt.gz	school_level
4pt5-3vv4.Location.txt.gz	lat/lon_coordinates
4qii-5cz9.BOROUGH.txt.gz	other
4twk-9yq2.CrossStreet2.txt.gz	street_name
52dp-yji6.Owner_First_Name.txt.gz	person_name
52dp-yji6.Owner_Last_Name.txt.gz	person_name
5nz7-hh6t.BORO.txt.gz	other
5nz7-hh6t.CORE_SUBJECT___MS_CORE_and__09_12_ONLY_.txt.gz	subjects_in_school
5uac-w243.Lat_Lon.txt.gz	lat/lon_coordinates
5uac-w243.PREM_TYP_DESC.txt.gz	type_of_location
62mr-ukqs.BROOKLYN___COOPERATIVES_COMPARABLE_PROPERTIES___Building_Classification.txt.gz	buiding_classification
6anw-twe4.FirstName.txt.gz	person_name
6anw-twe4.LastName.txt.gz	person_name
6je4-4x7e.SCHOOL.txt.gz	school_name
6je4-4x7e.SCHOOL_LEVEL_.txt.gz	school_level
6kcb-9g8d.independentwebsite.txt.gz	websites
6kcb-9g8d.neighborhood.txt.gz	neighborhood
6rrm-vxj9.parkname.txt.gz	park/playground
6wcu-cfa3.CORE_COURSE__MS_CORE_and_9_12_ONLY_.txt.gz	subjects_in_school
6ypq-ih9a.CORE_SUBJECT___MS_CORE_and__09_12_ONLY_.txt.gz	subjects_in_school
72mk-a8z7.ORGANIZATION_PHONE.txt.gz	phone_number
72ss-25qh.Agency_ID.txt.gz	city_agency
72ss-25qh.Borough.txt.gz	borough
72ss-25qh.Website.txt.gz	websites
735p-zed8.CANDMI.txt.gz	other
735p-zed8.EMPCITY.txt.gz	city
7btz-mnc8.Provider_First_Name.txt.gz	person_name
7btz-mnc8.Provider_Last_Name.txt.gz	person_name
7jkp-5w5g.Agency.txt.gz	city_agency
7yds-6i8e.CORE_SUBJECT__MS_CORE_and_9_12_ONLY_.txt.gz	subjects_in_school
8gr8-ngjc.phone.txt.gz	phone_number
8i43-kna8.CORE_SUBJECT.txt.gz	subjects_in_school
8isn-pgv3.Owner_Telephone.txt.gz	phone_number
8jfz-tjny.Agency.txt.gz	city_agency
8k4x-9mp5.Last_Name__only_2014_15_.txt.gz	person_name
8vgb-zm6e.City__State__Zip_.txt.gz	other
956m-xy24.COMPARABLE_RENTAL_1__Building_Classification.txt.gz	buiding_classification
956m-xy24.MANHATTAN_CONDOMINIUM_PROPERTY_Building_Classification.txt.gz	buiding_classification
956m-xy24.MANHATTAN_CONDOMINIUM_PROPERTY_Neighborhood.txt.gz	neighborhood
99br-frp6.BOROUGH___COMMUNITY.txt.gz	borough
9b9u-8989.DBA.txt.gz	business_name
9z9b-6hvk.Borough.txt.gz	other
a5qt-5jpu.STATEN_ISLAND_CONDOMINIUM_PROPERTY_Neighborhood.txt.gz	neighborhood
a5td-mswe.Vehicle_Color.txt.gz	color
a6zp-tcs3.Agency.txt.gz	city_agency
a9md-ynri.MI.txt.gz	other
ac4n-c5re.PRINCIPAL_PHONE_NUMBER.txt.gz	phone_number
ad4c-mphb.MANHATTAN_CONDOMINIUM_PROPERTY_Building_Classification.txt.gz	buiding_classification
aiww-p3af.Cross_Street_2.txt.gz	street_name
aiww-p3af.Incident_Zip.txt.gz	zip_code
aiww-p3af.Intersection_Street_2.txt.gz	street_name
aiww-p3af.Park_Facility_Name.txt.gz	park/playground
ajgi-hpq9.BORO.txt.gz	other
ajgi-hpq9.CORE_SUBJECT___MS_CORE_and__09_12_ONLY_.txt.gz	subjects_in_school
ajxm-kzmj.NeighborhoodName.txt.gz	neighborhood
as69-ew8f.StartCity.txt.gz	city
as69-ew8f.TruckMake.txt.gz	car_make
b9km-gdpy.ZIP.txt.gz	zip_code
bawj-6bgn.BRONX_CONDOMINIUM_PROPERTY_Building_Classification.txt.gz	buiding_classification
bbs3-q5us.EMPCITY.txt.gz	city
bdjm-n7q4.CrossStreet2.txt.gz	street_name
bdjm-n7q4.Location.txt.gz	lat/lon_coordinates
bjuu-44hx.DVV_MAKE.txt.gz	car_make
bs8b-p36w.STREET.txt.gz	street_name
bss9-579f.BROOKLYN_____CONDOMINIUMS_COMPARABLE_PROPERTIES_____Neighborhood.txt.gz	neighborhood
bty7-2jhb.Owner_s_House_City.txt.gz	city
bty7-2jhb.Site_Safety_Mgr_s_Last_Name.txt.gz	person_name
by6m-6zpb.interest.txt.gz	areas_of_study
	